11 1 1 1 1 1 1 1 11
10 0 0 0 0 0 0 0 01
1 --- | --- | --- 1
10|0|0|0 0 0|0|0|01
1 --- | | | | --- 1
10 0 0|0|0|0|0 0 01
1 ----- | | ----| 1
10|0 0 0 0 0 0 0|01
1 | ----- ----- | 1
10 0 0 0 0 0 0 0 01
1 ----- --- ----- 1
10 0 0 0|0|0 0 0 01
1 --- | --- | --- 1
10|0|0|0 0 0|0|0|01
1 --- | --- | --- 1
10 0 0|0 0 0|0 0 01
1 -----     ----- 1
10 0 0 0 0 0 0 0 01
11 1 1 1 1 1 1 1 11