************************************************************
**                           **                           **
**  **********  ***********  **  ************  *********  **
**                                                        **
**  **********  **  ********************  **  **********  **
**              **           **           **              **
**************  ***********  **  ***********  **************
            **  **                        **  **
**************  **  *********  *********  **  **************
                    **                **
**************  **  ********************  **  **************
            **  **                        **  **
**************  **  ********************  **  **************
**                           **                           **
**  **********  ***********  **  ***********  **********  **
**          **                                **          **
****        **  **  ********************  **  **        ****
**              **           **           **              **
**  ***********************  **  ***********************  **
**                                                        **
************************************************************