************************************************************
**                                                        **
**                                                        **
**                                                        **
**  **********  **  ********************  **  **********  **
**              **           **           **              **
**************  ***********  **  ***********  **************
            **  **                        **  **
**************  **  *********  *********  **  **************
                    **                **
**************  **  ********************  **  **************
            **  **                        **  **
**************  **  ********************  **  **************
**                           **                           **
**  **********  ***********  **  ***********  **********  **
**          **                                **          **
****        **  **  ********************  **  **        ****
**              **           **           **              **
**                                                        **
**                                                        **
************************************************************